11111111
1PEC0C11
10000001
10000001
10000001
10000001
10000001
11111111