11111111111111111111111
1SS00C110000000000000E1
1SS000000000000000CC001
10000000001110000000001
10000000000C10000000001
10000000000110000000001
1P0000000000000000000C1
100000000000000000000C1
100010000000000000000C1
100000000000000000000C1
100000000001000000000C1
100010000000000000000C1
100010000000000000000C1
100011100000000000000C1
100000000000000000000C1
100000000000000000000C1
11111111111111111111111