11111111111111111111111
1SSS0011000S00000EP0CC1
1SSSS000000000000000001
11CCC000000000000000001
11CCC000000000000000001
11CCC000000000000000001
11CCC000000000000000001
11CCC000000000000000001
11111111111111111111111